--------------------------------------------------------------------------------------------------------------------------------------------------------------------------------------------------------------------------
-                 ---  M    -                       ---                    ---            ---           ---                              -      ---                 ---      -                          -               -
-      -----                -        M           ----                                                                 ----    -----                                           -                          -               -
-           -- h       b-            --                   --                     --             --            --    -  -           --                --               - --  ---                          -               -
-            --     --            - -    -  -     -       --                     --             --            --       -            --            --             -- --    --  -        - -               -               -
-        %  $             -          -          -                                                                     -                                    --                -       -   ----------------         -
--     ----x        --  L -        ---      --            --    -                --    -        --    -       --   --  -      ----                --    -     -        --    --            -            --             --a-
-           ----           --             -                                                 $                          -           ----                       -                       -      --            -             -
-                   ---                              ---                    ---            ---           ---      -    -                          ---                 ---           -                   -   -            -
-        --                    -- -                                --                                                  -       --                                                  -               -----     --          -
-      +     P   --    ---               ---         ------------------------------------------------------------------------------------     --    ---           --    ---    - -                -                      -
-      ---             -                -                -                      -              -             -                ---       -            -                   -   -       -         -- -       ---     ----   -
-           M-    ---                - -      ---    ---                    ---            ---           ---                            ---     ---          ----       -----       - -                                  -
-   -----------                 ---            -- -                    ---                               L     -----xxxx   ----------   -                                              -     -----                ----   -
-                     ----                 ---            ----                   ----           ----         -----     -            --  -           ----          -----      ----       -                 ----           -
-             $  -                   -             -                      -              -             -               -         @      -      -                  - -                    -                      -------- -
-      ---          --         -- - -  -        --         --                    --             --            --       -      ---  - -  -         --   L     - - -       --       $      ---                    -        -
-           - ---                       - -        -                B     -              -             -               -          -- ----     -                   -                     --  ---                --     $  -
-       ---           ---                               ---                  ---            ---           ---         -        --      -           ---                 ---                                     -        -
-       ---           ---                              ---                    ---            ---           ---         -       ---      -           ---                 ---              - --- --               -        -
--------------  ------------------------------------------------------------------------------------------------------------- ------------------------------------------------------------------------------------------ -
-                                --                                                                                      @  - ------------------------------------------------------------------------------------------ -
-           -           --              ---                                           ---     ---------      ----     xx-   -                                                                                      -     -
-                 -             ---              -------------       ----       ---                    ----           xx-   -   ---------------------------------------------------------------------------------  --    -
-                                 --         --  -----------------------------------------------------------------------    -                                                                                   -        -
-          --         ---                 ----                   xx--         -------         ---     --               -    ----------------------------------------------------------------------------------     -@-   -
-                                 --               --     -----                                                                                          $                                                      -  -     -
-----------------------------------------------------------------------------------------------------------------------------------------------------------------------------------------------------------------  -------
-                                                                                                                      -                                                                                                 -
-                                                                                           M                               M                          L                                                                 -
---------------x    x-----------------------------------------------------------------------------------------------------------------------------------------------------------------------------------------------------
-                                                                                                                                                                                                                       -
-              ---                                                 $                                                   -                                                                                              @
-------------------------------------------------------------------------------------------------------------------------------------------------------------------------------------------------------------------------------------
