----------------------------------------------
-                                            -
-    $        $             $                -
-   ------------------------------------------
-        $              $           $        -
------------------------------------------   -
-    $            $            $             -
-  -------------------------------------------
-    $        $              $         $     -
-------------------------------------------  -
-             $              $       $       -
-  -------------------------------------------
-    $         $             $               -
-----------------------------------------    -
%          $           $        $            -
----------------------------------------------
