--------------------------------------------------------------------------------------------------------------------------------------------------------------------------------------------------------------------------
-                  -                                                                                                                                                                                                     -
-               %               ---------                                                                                                                                                                                -
---------    -----------------------------------------------------------------------------------------------------------------------------------------------------------------------------------------------------  ---  -
-$     @-    -$                                                                                                                                                                                                ---  ---  -
-       -    -$                                                                                                                                                                                                ---  ---  -
-     ---    -$                                                                                   M                                                           -                                                ---  ---  -
-  $         ---------------------------------------------------------------------------------------------------------------------                            x                                L               ---  ---  -
-       -    -$               M                                                                                                x                              -         -                            -         ---  ---  -
- --    -    -$                                                                                                                                                         -               M      M     _         ---  ---  -
-       -    -------------------------------------------------------------------------------------------------------------------------------------------------------x--------------------------------------   ----  ---  -
-    -- -    -                                                                        @                                                                                                                        ---  ---  -
-       -    -                                                                     -                                                                                                                      --   ---  ---  -
-       -                                                                         -M                           -MM-                                M                                                           ---  ---  -
----------------------------------------------------------------------------------------------------------------------------------------------------------------------------------------------------------  ------  ---  -
                                                                                                                                                                                      $             -       ---  ---  -
-                                                                                                             L                                           ----------                    ---            -       ---  ---  -
-----------------------------------------------------------------------------------------------------------------------------------------------------------                --                          -       ---  ---  -                                                                                                                                                                                                                     -XX-
-                                                                                                                                                         -         --                                 -       ---  ---  -
-                                                                                                                                                         -  L                       ---               -       ---  ---  -
-                                                                                                                                                         -                --                          -       ---  ---  -
-                                                                                                                                                         -           --       M           --          -       ---  ---  -
-                                                                                                                                                         ------------------------------------------   -       ---  ---  -
-                                                                                                                                                         -                                            -       ---  ---  -
-                                                                                                                                                         -                 $                          -       ---  ---  -
-                                                                                                                                                         -   ------------------------------------------       ---  ---  -
-                                                                                                                                                         -                                            -       ---  ---  -
-                                                                                                                                                         -                  M                         -       ---  ---  -
-                                                                                                                                                         ---------------------------------------      -       ---  ---  -
-                                                                                                                                                         -                M                           -       ---  ---  -
-                                                                                                                                                         -      ---------------------------------------       ---  ---  -
-                                                                                                                                                         -                                                         ---  -
-----------------------------------------------------------------------------------------------------------------------------------------------------------------------------------------------------------------------xx-
