----------------------------------------------
-    ---    ------       -----      --       -
-     $  -   $ $         $  $       $        -
-    ---    ------       -----      --       -
-     $   -  $ $     -   $  $       $        -
-    ---    ------       -----      --       -
-     $      $ $         $  $       $        -
-    --- -  ------   -   -----      --       -
-     $      $ $         $  $       $        -
-    --- -  ------  -    -----  -   --       -
-     $      $ $         $  $       $        -
-    --- -  ------   -   -----      --       -
%     $      $ $         $  $   -   $        -
----------------------------------------------
