--------------------------------------------------------------------------------------------------------------------------------------------------------------------------------------------------------------------------
-         -                                                                                                                                                                                                              -
-         -                                                                                                                                                                                                              -
------    -                                                                                                                                                                                                              -
-         -                                                                                                                                                                                                              -
-       $ -                                                                                                                                                                                                              -
-      ----                                                                                                                                                                                                              -
-         -                                                                                                                                                                                                              -
-$        -                                                                                                                                                                                                              -
----    $ -                                                                                                                                                                                                              -
-         -                                                                                                                                                                                                              -
-      ----                                                                                                                                                                                                              -
- $       -                                                                                                                                                                                                              -
-----     -MMMM                                                                                                                                                                                                          -
-         -MMMM                                                                                                                                                                                                          -
-       $ -MMMM                                                                                                                                                                                                          -
-    ------MMMM                                                                                                                                                                                                          -
-         -MMMM                                                                                                                                                                                                          -
- $       -MMMM                                                                                                                                                                                                          -
------    -MMMM                                                                                                                                                                                                          -
-         -MMMM                                                                                                                                                                                                          -
-       $ -MMMM                                                                                                                                                  ---------------------------------------------------------
-     -----------                                                                                                                                                -                        -                              -
-         -                                                                                                                                                      -                                                       -
-$        -                                                                                                                                                      -               -                                       -
-----     -                                                                                                                                                      -               -                                       -
-         -                                                                                                                                                                     --                                       -
-       $ -                                                                                                                                                                                                              -
-     -----                                                                                                                                                                                                              -
-         -                                                                                                                                                      -                          -            B               -
-                                                                                                                                                                -                          -                            -
-                                                                              MMMMMMMMMMMM  M    M    M   M  M  M  M  M   M   M  L   M  L  M  L M   M M         -                          -                            %
--------------------------------------------------------------------------------------------------------------------------------------------------------------------------------------------------------------------------
